10
S00#000000
0000#00#00
0##0#00000
000000###0
000#00#0#0
##0#00000#
#00#0##00#
##000#0#00
000#000000
0000##000G